# system
alias apt-get='sudo apt-get'
alias ins='sudo apt-get install'
alias update='sudo apt-get update && sudo apt-get upgrade'
alias python='python3'
alias py='python3'
alias root='sudo -i'
alias bashreload='source ~/.bashrc'

alias aliasy='vim ~/.bashrc_aliases'
alias funkcje='vim ~/.bashrc_functions'

# ssh
alias wit='ssh wasilea3@oceanic.wsisiz.edu.pl'
alias witunix='ssh wasilea3@unix.wsisiz.edu.pl'

# ls
alias ls='ls -hFA --color=auto'
alias l='ls -C --group-directories-first'
alias l.='ls -d .*'
alias lk='ls -oSr'
alias lt='ls -otr'
alias lm='ll --color | less -r'
alias lo='ls -vo'

alias ll='ls -ov'
# alias ll="ls -lv --color --group-directories-first | awk '{k=0;for(i=0;i<=8;i++)k+=((substr(\$1,i+2,1)~/[rwx]/)*2^(8-i));if(k)printf(\" %0o \",k);print}'"

# files 
alias rm='rm -dI'
alias rr='rm -rf'
alias cp='cp -ir'
alias mv='mv -i'
alias mkdir='mkdir -pv'
alias mk='mkdir'

# useful
alias q='exit'
alias c='clear'
alias cs='clear;l'
alias k='kill'
alias t='time'
alias h='history'
alias j='jobs -l'
alias calc='bc -l'

alias diff='diff --color'
alias diffu='diff --color -u'

alias du='du -h'
alias DU='du -had1 | sort -h'
alias d='du -sh *'
alias mount='mount |column -t'
alias ps='ps auxf'

# PATH
alias back='echo $OLDPWD;cd $OLDPWD'
alias ..='cd ..'
alias ...='cd ../..'
alias fhere="find . -name "


# for desktop in WSL
alias desktop='export DISPLAY=:0.0; xfce4-session'

